  #      #                #  #    # ## ###     #     ##     # #  #  # ##      #    # # ####  ##   B#
#     #### # #   #       # #      #               ## #      # ###  #    #      ###        #    # # #
  ##   #     #     # #     #  # # #  # #     ## #  # #   # ##     # ## #    #       #   ### #     ##
  #     ## #  #    ##     ##  #  ###  ##     #   #       # #         ##   #         #   #     #   ##
#   # # ## # # #  #    #   # #     ##     #   ##  #  #         #     # ## # ##  # #   #       ### ##
  #     ##  #  # #  #       ####  # ##   #     #   #  #  # #  ## #   #        # # ## #   #    ## ###
          # # # #    ###      #   ## #   #   #   #     ## ##   ## ##    #         #   ## ##    # # #
## # ###    #  #   #       #   # ##       #     # #  ###    #  #       #         # #      # ## ### #
#    #     #  ##          ##   #       # ##     # # #   ## #          #   #      # # #  # #     #  #
  # #    # ## # #    ##  #           # # #      #  #     ###         ### #   # #       #     # # # #
  #   # #   #        # ##        ##   # # ##     #  #  #    ##   ###   ####      # ##  ##  #     # #
     ##  # #                   # ### #  ##  ###        #  #    ##  # ### #  #  # ##  # ### ## #    #
# #     # #     ###     # # ###  ## # ##    #       #       ## ##   #   #  ###   #    # #  #  #   ##
###   ## #  ##  #   #    # #   #        #            ##  ##   ##   #  #     #   ### # ##  # #   # ##
#   # ##  #  # # # ##  # #   ##  # #   ##   # ##      # # ## #   #          ##   ###     #    # ## #
# ##       # #   #   ##  #    ## ##  ###    ## #   #       ##        #    #    ##       # #####    #
##  # # #  #   #     # ##     #  #  #   #   #     #    # ##  #  #   #       # ##   #####   #       #
##           ##   #  #    ###    #    ##     ##  #   #    #   # ## #   #      ### ##  #       ##   #
      # #  ###   ###  #          ## #      ## # ##          #  #      #     ##   # ###    #        #
    # #     #  ##       #        #  #     #     # # #   #    #              ##   # #   #       #   #
##    # #  # ##    ##       #  # #     # #      ##       #    ##   #        #      #  # ## #    ####
   #  ##     # #     ## # #   # #      #    #     #  #  ##  #      #     #     ##   ### # ##     # #
  #  #  #  ##  #   ##        ##  ###    ##    ## #    #  #  ######## #     # #   #         ###     #
#     ## ##   #             # #    #   #  #  ## # ### ##  #    # #    ##  #  # ##  ######        # #
##    #   # # # #  ##           ###    #  #  #  #    # # ##   #      ###     #        #   ###      #
     ##  ###   ##  # #    #  #   #####   #     #     #   ##        #       #  ##   ##      #   #   #
  ## #     ##  ## ##  # ##  # ##      #   #       # ###     #   ##     #   ####    ## ##     #    ##
  #  #        # #  #           #       # #    ##  ###         #  ##     #   #   # #   # #   ###   ##
   #         #    #       #   #  #  ######     # #  #     ##  #   # #  # # #    #  #    #          #
    #          #   #                ##        # ### ###      # ##    #   ##   #  ## #  # #     #   #
       ##    #    ##   ## #      # #         #  # #  #   #    #     ##   # #   ##    ###  ##  #    #
   #    ###       #   #       ##   #         ## ##     #             #  ##           ## #       ## #
 #   #      #          ##    # #     ###  # ### ## # ##  #      ### # ##    ##   #        # ##  #  #
  ## #   #       # # ## # #  #  # #  #   # ###     #  ##  # ##  #      ## #  # # #  # ###### # # # #
  #        # #   # ##     ####   #    # ##  #      # #   ##      #  #         ## ## ## #   #       #
#   ##           #  #   ###  # ##       #   # ##      # ## ##    #    #  #   ##  ##  # ###  # ### ##
  ##             #       #  ### #       #          #       ##      ## #   #      #             ##  #
   #  #   # #      #  #  ## #    #####  ###  # ### #  ##  #    #   ##    #    # # #   #   ###   #  #
# #      #  ###  # ###    #     #   #    ##   #  ##            #    ##     ## #       #    #       #
              #  #     #  ##      # ##     # ###      #          #  #   ##   ##      #   ##      # #
   #  ##  #  ####  #  # ##      #    #  #  #         ##    ###   #      ##   ##      #          #  #
 ### ###    #  #  ###### # #  ## ##     #       #  ###   #     ###    ###    ###    #####  #       #
            #  ##     # ### #  #  #   #      #   #     #    #  #  #      # #    ###  # ##  #  #    #
   ##        # #  #      #  #  ## # #                #     ## #          ## # #  #  ## #   # ###   #
       ##        #     #  #     #    ####    # #  # #    #         # #   ### #  #      #          ##
   ##  #  ###### #      # #  ## #    ## #  # #   #    # #       #   #    # #            # ## #   # #
      # ##   ##      #   ##  # # #  #        ## ##  ## #     ### #   #   #   ### ##    #  #      # #
     #     ##  # ##    ####      # #    #   #    #  ###  #      #  #  # #    # #   ##   #  #    # ##
 #   # ##  #  #    ## #    #   #   ##  ## # ##    # #   #   #  #  # # ###### ####   #   #  ## ###  #
    #####       #      ####  # # ### #      #    # ## ## #       #        ##   #      #    # #     #
  # ##               ###   #        # ##   # # ##    ## #  #  #      # ###   #  # ##          # ## #
 #  #       #  ##   ###   ##       # ## ##  ##        #      # ##       ## #  ##      #### ###  #  #
 #         # # # # #    #   #      # #      ## # #  # #          # #   #    ## #   # #   #   # #   #
     ##    ##     #      # #         # # #  #    ### #### ##        # ##### ##    #   # ##  ## ##  #
        # # ##  ###  #    #      #       # #  # ### # #    #  #       # ##  # #     ##  #      ### #
         #         ##        # ##    #    ##  # ###      #   # ###  # #  ## ## #   #   ##    #  ## #
 #    #   # ## # #  #   #       #    #     ##        # #  #         #  #      #   #  ##     #  #   #
     ##  ## #  #  #   #   ## # #          # # #  # #  ##        # # # #      ##  #  # #   ###      #
# #             # # #  ###  # #   #   ####  #     ##                #  ##  #      ##  ## # #     # #
#  ## #      #  ### #        #    # #  # #     ##  ### #  ## #   # #   ##    #   # # # ###         #
  #     ###  #  ##### #   # ## # #   #           #       #####    #     #  # #   #        #     #  #
  # # #   #   # #  #    ####      #  #   # #   #   ##      ##               #  ##       ### # # #  #
  # #   ##     ## # ##    ##  #    ###   # #  ### ##        # #      # #  ###  # ### ##  #  # #    #
       # #  ##   #     # ##  ## ##  # ##            #     #     ##      # #  #  #       #     #  # #
  # #  # # # ###  ##     # #   #  ##  ## ##  #          ##  ##     #   #        #         #  #     #
##   #  # #  #     ##   ##   #    ##   #     ##     #  #        # #        # # #       # #  ## ### #
#     #     ##       # ####  #     ###   #  #  #  ## #    #  #   #       #     #  #     #          #
   # #  #   # #   #  #  ##    # ## #   # ## ##  #  ### # ###  #     # # #   #  ###  #       #  # ###
     #   ### #    #  #         # #     #      #      #        # #     # #    # ###  #  #  ## ## # ##
 #        #  ##  ### #       ###  # #   #  #   #           #          # # # #   #     #   #    #   #
#   #    ####    #                ##  #        #     # # # #     #     #   # ##   #              ###
#   # ## ##     ##     #   #    ## #      # #    #   # # ##        #     # ###  # #   #   #  ##    #
      #      # #   #    #       ####  # # #               #   #   #      ## #   # # # #  ##    # ###
       #### # # # #  #   #     ## #   #  #     # #   #   # # #   ##   #  ## #  #  # # #    ##     ##
 # #    #   #   #  # # # #  ##   ### #    #    # # ###  ##   #  ##    # ###  #  #     ##   #      ##
##       #      #         #    ##          # ## ##        ##  # #   ## ###    # ##      ##   #  #  #
     #  #              #     #  ###  ## # #   ##          ## # # ##    #    ##  # # ##         ##  #
#            ##   #      #    #  ##   ##    #  ##   # #       #  # #     #    ##  ##   #    ## #####
## #   #  #  #  ## #   ###  #     #  ##  ###  ##    # ## #       # ### #   # #  # #              ###
       ##   #      #  ## ###      #  ##       #   #  ## ##   ##        # #            #   #        #
  #  ## ##   #   #   #   # # #   ### # # #   #   # #   #       #   #       #              ##     ###
   ##   #       ##     #   #    ### #     #           #   ##   # #  #  #    # #   # # ##   ## #  ###
 #  #    # #            # ####  #  # # #  ## #     ###   ## ## ##   ### ####  ##   #        #  ##  #
    #   #  # # #   ##  ### ##  ### #  #   ##  # # #   #                   ##  ##   #         #  #  #
     # #            #   #  #     ##     #      #  #   # #  #  ##  ##   ##  # ##  # # ##   ## #     #
   # #      #   #  ##    ##  # #  #     #  # # #        #     # # ## #   #  ## ## #      #  ##   ###
  #   # #      ## #        #  ## #  # # ## # #  # # # #    #  ##    ##  ## ### ##########          #
 #   #   ##   # # #### # #  #  ##   # #      ##          #   ## #  ##           ##  ###   #    #  ##
          #        # #      #### # ## #  #   #  ##      #       #   #  #   # ###   #   ##          #
    # ## # ##     ##    #  #     #  ##     ##  # #   #### ##          #### # # ##         #  # # # #
  #  #    #   #     #  #     ###          #          #  # #      ##   #  #  #    ###   # ###   #   #
             #  #   #   #   #        #  #   ####     ## #  ###    #   ## ## #  ##  #     #  ### ## #
 #    #     # # ##    #  #     # ## #              #       #           # #          ###  # ##  #   #
 # #  #       # #   # #   # # ## ##       #    # #    #      ##      #    #    ##        ###   ### #
#          #    # #   #   ##     ## # # ##    ##    #    #   #  ## #     ##  ### # #  #   ##  #  ###
 # #            #     ##     #  #   #  #       #    # #   #     #       #    #  #       #   ## #   #
   # ###  #    #      ##     #  #         #     # ##    #  #         #      ##         #   ##  #  ##
  #    #    # #   #    # ### #      # #   #     #      ##      # #     ##  #   #     # # # #    #  #
 #    #    #    #  #      #     #  ## #  #     ##      ##   #       #    ####  ##                ###
# #A #         #  ##  ## #           #       #   ##   # ##       ##    # #    ###  #  ###  ##   #  #