 #  #         #    #    #                   # ##  #    # B##
      ###     ## # # # #   # ##    ##     ## ##   ##  #    #
  ###  # #   ##  ###    #  #   # ### #  ##    ##    #     ##
#    #   #    ##   # #   ###   #         #   #    #     ####
                # #  #   ##  #   #    ##  #  #       #  #  #
  #      #        ##   #   ###  ##   # #    # ## #  # # #  #
  #    ###       #     # #    # #   #  # ##   # #      #   #
  # ## # #  #  ##     #      #   ###    #      # # #    #  #
           ##  # # #   #         ##  #  #  #  #      #    ##
 ###            ###   ##  # #     #      #  ##  #    ##  ###
 #  ##   #  ###     #    #      # #    # ## ##    #        #
#   ###    #      # # #    #              ##  # ###        #
#  #  ##  #  #  #     # # # # #      ##  # ##  #    #   ## #
           #    #   # # # #  ##    ## #    #         ### # #
#          ##  #    ### ####  # #  #        #  # # #   # # #
 #     #   # #          #    ##  ##    ###         ## #    #
#         ## # ##  ##    #      ## #   # # #   ###         #
 #     #   # ##        #    ### #  #        # ##       ## ##
  # #     ##   #      #          ##   #                 ####
               #  ###  #    #      # ##  #    ##    #### # #
 #       #     #    ###  #         # #    ##             ###
  #         ## ##            # ###       # ### #      ##   #
# # #  #    #    #   ##    # #          #    #   #         #
 # #       ##  #  # ##    #   #  #  # ####  ##  #          #
     #   #    ###     # # # # ### ##   #       ##         ##
  # #   #      #     # ## #         ###    #    #    ##  ###
#     #       ## #  # ## #   ##    #  # #      #         # #
#   # #       ###  # ##       #  # #   #    ##    #  #    ##
 #   #   #  #   ##      # #     #  #   ##                  #
      #      # # #######        #  ##    # #  #  #  #    ###
       #       #        #       # #      #  #  #  #   ##   #
 ## ##  # #      #  ###          ##  ##  ###       #   ##  #
#   ###  ##  ##  ### # ##        ##### ### ## ####  # #    #
             # # #     #     ##   # #  #       # #         #
 ##  #  ### #####     #        # #   # #   ## #          # #
        #   #    #    ##    ###  #  #  # ## #     #      # #
#       #     #     ## ##  ##    #      #      # ###      ##
       # #    # ##  #   # #  # #       #  # ##  # #      ###
     #       ##     # ##   # ## ##        # #####  ## ##   #
  # #   ##    ###     ####         # ## # ## #           # #
  #          #  # #    # ##  #    ##            #   #   #  #
    #   # #           #                ##  # ## ## #    ## #
    #  # #  #  ##     #  ##     # # # ##   #   ###  #  #  ##
       #    #         #    #        ### #    #      #  # # #
 #  ##  # ##    # ###   ### #           #   #   #       ## #
               # #   ### ## # #      ##    #     #   #  #  #
   #      ##   # #       ### # #  #  ## # # ##  #      #   #
     # #     #   # #    # #              ###   #    #    # #
 # #  #  ##   ##         #          # #  ##   ## ## ## #  ##
A                 ## #        ###   #      #    # #  #     #