    # #    #    #   ###       #   ## #  #  # #   # # ##  #      # # #  #    # B#
   #   ## #       # ##    # # #         #   #       # #   #  #     #    #  #   #
  #  ##            # # #      # #   ##      # ## #  #   #  #  ##     ### # # # #
  ##  ##  ##   #  #  # # # #####   #   #  ####   # #  #             #      # # #
 #   #   #   ###   ##     #   #    ##   #  #  # #  #    #      # # ##        ###
#            #         # #    ## #    #      #       #        #  ##  # # ##    #
# #  ### ##     ## #   ## #  #     #    #  #       #### #      #  #      ##    #
 ##   #  # # ###  #      ####         #   ##        #       #  #  # #   ### # ##
 ##                    #    #  # ###  #      ###   ###      # #        #   #   #
   ##           #    ##  ##             #  ## ## #  #  #    ## ## ##  #  #     #
 #     #  # #    #  ####          #    #    #                     #  ## #  #   #
# ## #    ##   # # #### #   ### ###      #  #      #  # ##            # #    # #
          # ## #  ##                ##   ##    #    #  ###  ##  #    ### #  ## #
           ###   ##      #  #  #  #   #  #    ###     #     #      # #   ## # ##
   ##     #  #  #   #########    # #     # # ##         #             #  ###   #
##  # # ##    #      #        ##  #          # #   ##  #  #    ##  ##         ##
  #         #   ##     #       # #  # #      #   # ## #  # #  #  ###  #        #
  ## #       #  #   ###          ###   #         ##             #    #  #  ##  #
 #     #     ###   #           ## ##  #  ###   #    #  #        ##         #   #
  #      ###              #         # #  #         #  ###  #  ###  ###     #   #
#       # ## #         ###            ##             ##   #  # #   ###     # ###
    #        ## #   #    #      # #  # #     ##  ##   ##    ##      #   ##   ###
        #     # #  ### ##   # #   ##   # ##  # ## ##      #  #   #### #  #   # #
#         # #   # # #   ### #   #    ##   #  #          #  #             ## #  #
           #   ##  # #    #  # # #             #     #  ###         # #  #   # #
  ###   # #  ### # ##    ##    #      #  ##  #                #  #  #      #  ##
  # ##        ###   # ## #     # # #         #   ##  #  ##       #  # #    #  ##
    ###    ##   ##   #  #      ##        ##  # #  #  # #  #   #         ###    #
 #    #   ##        #    #####   # #  # ## # #    #  #       #      ##   ##   ##
       #  #  #  #   #   #  # # #   ##      # #   ##    # #   #      #### #  #  #
    ###   #  ###   # #               #     # ##  ##   # # #     # ### #    #####
   #    # ##    ##      ### #            #   ## #          ##       ##    #    #
  #    # #  #  ##  # #   #   #  ##     #    #   ## #  ## # #         #   ##    #
    ##   #      #  #      ## #    ##  #   #  #  #    ## # # ###   ##   ##      #
 ###       #  #      #             ## #    ## # #   #     # #  ##  #      #    #
 #         ###  #    #  #    ##   #          ## # #     #     # #  #   # #  #  #
 # ###    ##    ##             #        # ### #     # # # #    #        # # # ##
   ### ###   #    ##  ### ##   #  #       #    ##  ## ##     #      # ##  ##   #
       #    #  # ## #  #    ##      # ##  #     # ##        #     # #    #     #
A#      #    #    ##    # # #   #       #   #  #   ##      #  #   #     #  #   #